22222222222222222222222222222222
20000000000000022222222222222222
20777777777777022222222222222222
20777777777777022222222222222222
20500777775004022222222222222222
20111111111111022222222222222222
20111111111111022222222222222222
20111111110222222222222222222222
22222228822222222222222222222222
20666661111661022222222222222222
20777775577777022222222222222222
20777775577777022222222222222222
22222228822222222222222222222222
22222228827777777777777777777777
20777771177777777777777777777777
77111111111117711111111111111111
77111111111117711111111111111111
77111111111117711111111111111111
77111111111114411111111111111111
77111111111117711111111111111111
77111111111117711111111111111111
77777777777777777777777777777777
77777777777777777777777777777777
77777777777777777777777777777777